walls: 5
optimal: 48

######-#-###
#O-----#----
#-###-##--##
#---#--B---#
###-#####--#
#-----#-----
#-###-#-#-#-
#-#---#C#-##
#-#A#####--#
#-###------#
------####--
--########--